Map:
###-##--##--
#---#-#-#-#-
##--#-#-#-#-
#---##--##--
###-#-#-#-#-
------------
-##--##-----
#--#-#-#----
#--#-#-#----
#--#-##-----
-##--#-#----
------------
------------
------------
------------
------------
------------
------------
------------
------------
------------
------------
------------
------------
------------
Map/

Meta:
Name: Default
Meta/

Legend:
#) red-block.png
Legend/