Map:
----####----
---#OOOO#---
--#OOOOOO#--
--#OO#####--
###OO#%%%#--
#O#OO#%%%#--
#O#OO#####--
###OOOOOO#--
--#O###O##--
--#O#-#O#---
--#O#-#O#---
--###-###---
------------
------------
------------
------------
------------
------------
------------
------------
------------
------------
------------
------------
------------
Map/

Meta:
Name: LEVEL 4
Unbreakable: %
Hardened: #
PoerUp: O
Meta/

Legend:
#) grey-block.png
O) red-block.png
%) teal-block.png
Legend/